and so on - i tak dalej
collectively - łącznie
fraction - ułamek
just a fraction more - tylko ułamek więcej
other proportions of some weight - inne proporcje o pewnej wadze
about the same - mniej więcej tyle samo
quarter of the whole - jedna czwarta całości
Japanese are a quarter of the whole - Japończycy to jedna czwarta całości
considerable - spora/znaczna
breakdown - podział
somewhat - trochę
It's somewhat surprising - To trochę zaskakujące
obviously - oczywiście
bringing in - przyciągają
bringing in students - przyciągają studentów
constitute - stanowić
Chinese who constitute the majority - Chinczycy którzy stanowią większość
the breakdown - podział
well after - grubo po
well after 6 pm. - grubo po 6 wieczorem
face - natrafić na
we face traffic - natrafiamy na korek
get back - wracać
that's a shame - szkoda
various - różne
Reptile Display - pokaz gadów
Koala Handling - Obsługa koali
catered lunch - lunch z cateringiem
swoop down - zlatywać
birds swoop down - ptaki zlatują
eagles - orły
falcons - sokoły
kites - kanie (ptak)
bring out - wypuszczać
birds of prey - drapieżniki
it's an hours and half on the road - to jest poltorej godziny drogi
picks us up - odbiera nas
as long as it isn't - dopóki to nie jest...
Tuesday we'll have some showers - We wtorek będziemy mieć przelotne opady
forecast - pogoda
certainly - z pewnością
Let's hope - miejmy nadzieję
Let's hope the weather is better - Miejmy nadzieję, że pogoda będzie dobra
school excursion - wycieczka szkolna
And I question - I poddaję w wątpliwość
the entire premise - cała przesłanka
And I question the entire premise of this piece - I poddaję w wątpliwość całą przesłankę tego tekstu
add it up - podsumujmy to wszystko/dodajmy to do siebie
good stuff - dobre rzeczy
shave - zaoszczędzić
shave bits of time off - zaoszczędzić trochę czasu
everyday activities - codzienne czynności
generally - ogólnie
doing a story along these lines - robić artykuły o podobnym charakterze
here and there - tu i ówdzie
savor - rozkoszować
savor that irony - rozkoszować tą ironią
speech - przemówienie
tardiness - spóźnienia
assume - zakładać
they assume two things - zakładają dwie rzeczy
find out - dowiadywać się
bulbs - cebulki warzyw
trim - przyciąć
lawn furniture - meble ogrodowe
hang out - rozwiesić
clothesline - sznurek do suszenia
I hand out the clothes on the clothesline - Rozwiesić ciuchy na sznurku do suszenia
fill the car up - zatankować samochód
sweep - zamiatać
sidewalks - chodniki
I swept the sidewalks - zamiatałem chodniki
fill up - napełnić
rake - grabać
I raked the lawn - Grabiłem trawnik
lawn - trawnik
I cut the lawn - Koszę trawnik.
Which is how... - W ten sposób...
heat out - ocieplenie
spin - obracać
spin the fans - obracanie/napędzanie wentylatorów
electricity - energia elektryczna
actually - rzeczywiście/w rzeczywistości
manufacturing - produkcja
giant heat pumps - gigantyczne pompy ciepła
entire districts - całę dzielnice
harness - wykorzystywać
creatively harnessing seas - kreatywnie wykorzystują morza
sewage - ścieki
heat sources - źródła ciepła
subsidies - dotacje
loom - zagrożenie
risks of climate change loom - oblicze zagrożenia związanych ze zmianą klimatu
an upfront - początkowa
an upfront investment - początkowa inwestycja
on utitilities - w rachunkach mediów
in the long run - w dłuższej perspektywie czasu
depending on - w zależności od
though - chociaż
powerful systems - wydajne systemy
consistently - stale
stays consistently warm - pozostaje stale ciepłe
opted for - zdecydować się na
draw heat - pobierać ciepło
Nevertheless - mimo to
icy - mroźna
leak out - wyciec
landfills - wysypiska śmieci
molecule - cząsteczka
potent geenhouse gases - silny gaz cieplarniany
drawbacks - wady
the refrigerant - czynnik chłodniczy
pick up - odebrać
expansion valve - zawór rozprężny
liquefy - skraplać
comparatively - stosunkowo
compressor - sprężarka
thermal energy - energia cieplna
molecules - cząsteczki
relatively - stosunkowo
coils - wężownica (coś jak rura)
refrigerant - czynnik chłodniczy
harness - wykorzystywać
harness the second law - wykorzystywać drugie prawo
heating - ogrzewać
cooling - schładzać
double as - pełnić rolę
they often double as air conditioners - często pełnią rolę klimatyzatorów
air conditioners - klimatyzatory
efficiency - sprawność/efektywność
oil or gas boiler - kocioł olejowy lub gazowy
counterparts - odpowiedniki
meaning less - co oznacza mniejsze
fossil fuel use - zużycie paliw kopalnianych
switch to - przechodzą na/przełączają się na
renewable energy - energię odnawialną
heating buildings - ogrzewanie budynków
emissions - emisja
CO2 emissions - emisja CO2
So much so, that... - Tak bardzo, że...
So much so, that in 2021... - Tak bardzo, że w 2021....
burning fossil fuels - spalanie paliw kopalnianych
Have been hailed - zostały uznane
climate-friendly - przyjazne środowisku
heaters - grzejniki
wizardry - czarnoksięstwo
What wizardry is this? - Co to za czary?
heat out - otrzymane ciepło
heat pump - pompa ciepła
to be conserved - być zachowanym
energy has to be conserved - energia musi być zachowana
jealous - zazdrosny
don't hesitate - nie wahaj się
You've given me a lot to think about! - Dałaś mi dużo do myślenia.
Check into it - sprawdzić to
You might well find the same is true for you - Może się okazać, że to samo dotyczy się Ciebie
sophomore year - drugi rok
By senior year - w ostatnim roku
ready to pack it in - być gotowym do spakowania
freshman year - pierwszy rok
from scratch - od zera
you've got almost a year under your belt - masz prawie rok za pasem.
But, so does Central - Ale, podobnie jak Central
get away from home - uciec z domu
the main reason - głównym powodem
keep the same major - pozostać na tym samym kierunku
homesick - tęsknić za domem
transferring - przeniesienie
Without such a dramatic start in life, it's unlikely any of them would have even got this far. - Bez tak dramatycznego startu w życiu jest mało prawdopodobne, że którekolwiek z nich zaszłoby tak daleko.
Reunited - zjednoczeni
catch up - nadrobić zaległości
lead - wyprowadzić
survivors - ocalali
predators - drapieżniki
unaccounted - zagininoe
amongst - wśród
the rubble - gruzy
The resilence - odporność
barnacle goose chick - pisklęcia Bernikli białolicej
extraordinary - niezwykły
respond - odpowiadać
be in a bad way - być w złym stanie
gosling - gęś
A little dazed perhaps - może trochę oszołomiony
one piece - jeden kawałem
all in one piece - wszystko w jednym kawałku
chick - pisklę
good a descent - dobre zejście
controlled drop - kontrolowany spadek
launch - start
substance - substancja
sugary water - słodka woda
collect that - zbierać
raise bees - hodować pszczoły
it might seem mean of us - może wydawać się podłe
feed - nakarmić
honeycomb - plaster miodu
liquid honey - płynny miód
wax - wosk
passing it back and forth - przekazując go tam i z powrotem
thicker - grubszy
stickier - bardziej lepki
special liquid - specjalny płyn
figure out - dowiedzieć się
be confused by it - być zdezorientowanym tym
really gross - naprawdę obrzydliwa
pass it to - przekazać
spit it out - wypluć to
stomach - żołądek
storage - przechowywalnia
slurping - siorbać
very runny - bardzo lejący
honeysuckle - wiciokrzew
nectar - nektar
bumblebee - trzmiel
tongue - język
see-through - przeźroczyste
willing to live - chętnych do zamieszkania
tiny lenses - maleńkich obiektywów
bee suite - kombinezon pszczeli
can't get stung - nie można się użądlić
beehive - ul pszczół
stringers - żądła
pop our heads in there - wsadzic tam glowe
secrective - skryte
hive - ul
recipe - przepis
